################
#..............#
#.........1....#
#..............#
#.......2......#
#..............#
####....########