#######......
#..............#
#..............#
#......#####...#
#..............#
#..............#
####....########