######################################...#######################################
#########################..........###...............###.....................###
####...............................###.......................................###
####...............................###...............###.....................###
####...........##########......#######...............###.....................###
####...##################......################..#######.....................###
####...##################......###############...#######.....................###
####...................##......##########...........#################..#########
####...................##......##########...........#################..#########
####################...##......##########...........##.......................###
####################...##......##############.......##.......................###
####...................##......##############.......##.......................###
###....................##...........................##.......................###
###..############################...##################.......................###
##..#############################...##################.......................###
##..########.................................................................###
#..#########...###################################...###########################
#..#########...###################################...###########################
##..########...................###################...###########################
###..#############################################............................##
####..........................................####...........##############...##
#####..........................#..............####...........##############...##
######################################333#######################################